Midsummer Day
An Interactive Fiction by Will Shattuck
Release 1 / Serial number 200710 / Inform 7 build 6M62 (I6/v6.33 lib 6/12N) SD

Gazebo
A white canvas parasol raised up on stakes driven into the grass. Under the parasol sits a man in the white picket chair.  On the small table in front of him is a glass of what appears to be iced tea.

You can see a crate (in which are a croquet mallet and a blue hat) and Mr Jones here.

>l
Gazebo
A white canvas parasol raised up on stakes driven into the grass.

>w
You can't go that way.

>e
You can't go that way.

* * *

Midsummer Day
An Interactive Fiction by Will Shattuck
Release 1 / Serial number 200710 / Inform 7 build 6M62 (I6/v6.33 lib 6/12N) SD

Gazebo
A white canvas parasol raised up on stakes driven into the grass. Under the parasol sits a man in the white picket chair.  On the small table in front of him is a glass of what appears to be iced tea.

You can see a crate (in which are a croquet mallet and a blue hat) and Mr Jones here.

>look in crate
You can't see inside, since the wood-slatted crate is closed.

>open crate
It isn't something you can open.

* * *

Midsummer Day
An Interactive Fiction by Will Shattuck
Release 1 / Serial number 200710 / Inform 7 build 6M62 (I6/v6.33 lib 6/12N) SD

Gazebo
A white canvas parasol raised up on stakes driven into the grass. Under the parasol sits a man in the white picket chair.  On the small table in front of him is a glass of what appears to be iced tea.

You can see a crate (in which are a croquet mallet and a blue hat) and Mr Jones here.

>open crate
It isn't something you can open.

* * *

Midsummer Day
An Interactive Fiction by Will Shattuck
Release 1 / Serial number 200710 / Inform 7 build 6M62 (I6/v6.33 lib 6/12N) SD

Gazebo
A white canvas parasol raised up on stakes driven into the grass. Under the parasol sits a man in the white picket chair.  On the small table in front of him is a glass of what appears to be iced tea.

You can see a crate (in which are a croquet mallet and a blue hat) and Mr Jones here.

>open bag
It isn't something you can open.

>close bag
It isn't something you can close.

* * *

Midsummer Day
An Interactive Fiction by Will Shattuck
Release 1 / Serial number 200710 / Inform 7 build 6M62 (I6/v6.33 lib 6/12N) SD

Gazebo
A white canvas parasol raised up on stakes driven into the grass. Under the parasol sits a man in the white picket chair.  On the small table in front of him is a glass of what appears to be iced tea.

You can see a crate (in which are a croquet mallet and a blue hat) and Mr Jones here.

>close bag
It isn't something you can close.

>close carpet bag
It isn't something you can close.

>open carpet bag
It isn't something you can open.

* * *

Midsummer Day
An Interactive Fiction by Will Shattuck
Release 1 / Serial number 200710 / Inform 7 build 6M62 (I6/v6.33 lib 6/12N) SD

Gazebo
A white canvas parasol raised up on stakes driven into the grass. Under the parasol sits a man in the white picket chair.  On the small table in front of him is a glass of what appears to be iced tea.

You can see a crate (in which are a croquet mallet and a blue hat) and Mr Jones here.

>l at mr jones
You see nothing special about Mr Jones.

>get hat
That seems to belong to Mr Jones.

>get crate
It's far too heavy to lift.

>get mallet
Taken.

* * *

Midsummer Day
An Interactive Fiction by Will Shattuck
Release 1 / Serial number 200710 / Inform 7 build 6M62 (I6/v6.33 lib 6/12N) SD

Gazebo
A white canvas parasol raised up on stakes driven into the grass. Under the parasol sits a man in the white picket chair.  On the small table in front of him is a glass of what appears to be iced tea.

You can see a crate (in which are a croquet mallet and a blue hat) and Mr Jones here.

>get blue hat
Taken.

>wear hat
(the blue hat)
You put on the blue hat.

>get crate
As you stoop down, your hat falls into the crate.

It's far too heavy to lift.

>l crate
In the crate are a blue hat and a croquet mallet.

>get hat
Which do you mean, the blue hat or the top hat?

>blue
Taken.

>get crate
It's far too heavy to lift.

>wear hat
(the blue hat)
You put on the blue hat.

* * *

>get crate
As you stoop down, your hat falls into the crate.

It's far too heavy to lift.

>wear blue hat
(first taking the blue hat)
You put on the blue hat.

>get crate
As you stoop down, your hat falls into the crate.

It's far too heavy to lift.